#	PDB part
pdb_file	Benchmark/Ubiquitin/pdbs/1UBQ.pdb
chains	A 
residues ILE VAL LEU 
short_distance_threshold	6.5
long_distance_threshold	10 
#	NOE part                              
labelled_residues	ILE VAL LEU               
read_extracted_NOEs	on
extracted_NOE_list	Benchmark/Ubiquitin/dat/Ubiquitin_NOElist.txt
check_NOE_reciprocity	on	            
#	System dependent requirements
run_subgraph_isomorphism	on
priority_iterations	10
N_priority_MCES	3
merge_LV_label	off
merge_proRS 	on
merge_NOEs	on
min_size	1
mode	all_subgraphs
mces_mode	all
maximum_run_time	100
strip_mode on
